##############################
#         #              #   #
# ####    ########       #   #
#  o #    #              #   #
#    ###     #####  ######   #
#      #   ###   #           #
#      #     #   #  #  #   ###
#     #####    #    #  # x   #
#              #       #     #
##############################